000100000000000
000100000000000
000100000000000
000000001000000
000000001100001
000000000000000
001000000000000
111000110000000
000000100001111
000000100000000
000000100000000
000000000000000
001000000000000
111000000000000
000000000000000
000000011100000
000000000111000
000000000000000
000000000000000
000000000000000








